111111111111111111111111111111111111
1000P00000000000010000000000010C0001
1010C1010010000010100100000001010001
110000010101010001001000000010100011
1000C0000000000000000000000000000001
1000C0000000000001000000000000000001
110000010101010001001000001010100C11
1000C0000001000001010000000001000111
1000C0000000000001000000000C001000E1
111111111111111111111111111111111111