1111111111111111111111111111111111
1000p00000000000000000000000000001
1010c10100100000101001000000010101
1100c00101010100010010000000101011
1000c00000000000000000000000001001
1000c00000000000000100000000000c01
1000c00000000000100000000000010001
1000c0000000000001000000000c000001
1000c000000000000011000000000000e1
1111111111111111111111111111111111